#####
#@$.#
#####
;
 ########
##      #
#   .   #
#   $   #
# .$@$. #
####$   #
   #.   #
   #   ##
   #####
;
         ########
         #     @#
         # $#$ ##
         # $  $#
         ##$ $ #
########## $ # ###
#....   ## $  $  #
##...    $  $   #
#....   ##########
#########